leave of absence (from school) : 휴학
take one semester off (from school) : 한 학기를 휴학하다
go back to school : 복학하다
return to school : 복학하다
maternity leave : 육아 휴직
paternity leave : 남자의 출산 휴가
reinstatement : 복직
retire : 은퇴하다
resign : 사직하다
resignation : 사직
wrist : 손목
frustrate : 좌절감을 주다
shortcoming : 단점
palpable : 뚜렷한
recall : 기억나게 하다
tail off : 차츰 감소하다
little : 거의 없는
amateur
pivotal : 중심이 되는
pivot
traction : 견인력
strike a balance between : ~ 사이에서 절충을 하다
insistence : 고집
wrangle : (복잡하고 오래 계속되는) 언쟁
divisive : 분열을 초래하는
clause : 절
from the outset : 처음부터
underdog : (이기거나 성공할 가능성이 적은) 약자
shrink : (규모, 양이) 줄어들다
look forward to something : ~을 고대하다
every once in a while : 가끔
breakthrough : 돌파
leapfrog : (더 높은 위치등급으로) 뛰어넘다
way : (부사) 훨씬
either (영국식으로 아이더)
empower : 권한을 주다
novella : 중편 소설
hierarchical
resistant to : ~에 대해 저항하는
dissent : 반대
hostile : (~을) 강력히 반대하는
narrator : (소설의) 서술자
imprison : 감금하다
preach : (특정 종교·생활 방식·체제 등을 남이 받아들이도록) 설파하다
Ironically : 반어적으로
arc : (기하) 호
foreshadow : 조짐을 나타내다
revere : 숭배하다
plot : 음모
arguable : (충분한 이유를 들어) 주장할 수 있는
distribution : 유통
roster : 근무자 명단
boast : 자랑할 만한 ~을 갖고 있다.
foremost : 가장 유명한
loom large : (걱정, 위기 등이) 크게 다가오다
whether : ~인지 아닌지 : ~이든 아니든
hearsay : (다른 사람에게서) 전해 들은 말
urban legend : 도시 전설
proclaim : 분명히 보여주다
decry : 매도하다
obliterate : (흔적을) 지우다
promote : 고취하다
playful : 장난기 많은
figurative : 비유적인
cabal : (정권 쟁탈 음모에 연루된) 도당
seductive : (하고 싶거나 갖고 싶도록) 마음을 끄는
enrapture : 황홀하게 만들다
former : (시간상으로) 예전의
minister : 장관
alternative : 대체 가능한
spontaneous : 자발적인
antithesis : 반대(되는 것)
autocratic : 독재의
for certain : 틀림없이
constitute : ~이 되다
bunk : 허풍
corporate governance : 기업의 경영 구조
corporate : 기업의
governance : 관리 방식
capitalist : 자본주의자
extinction : 멸종
replete : ~이 가득한
exceedingly : 극도로
intertwine : 밀접하게 관련되다
democratic : 민주주의의
legitimacy : 정통
decentralize : (중앙 정부의 권력을) 분권화하다
specifics : (어떤 주제에 대한 논의 등을 위해 필요한) 세부 사항
emerge : 모습을 드러내다
eradication : 근절
marginal : 미미한
capacity
mentality : (개인, 집단의) 사고방식
fascinate : 마음을 사로잡다
Neolithic : 신석기 시대의
et al : 외
marvel at : ~에 놀라다
footnote : 각주
unbridled : 억제되지 않은
paradise : 낙원
far from : ~와는 거리가 먼
resort to something : (다른 대안이 없어서, 특히 좋지 못한 것에) 의지하다
legit : 합법적인
slickly : 매끄럽게
guru : 전문가
funnel : 깔때기
gushing : (열의, 칭찬, 감정을 과장되게) 마구 쏟아 내는
pseudo : 허위의
glance : 대충 훑어보다
confirm : (무엇에 대한 느낌이나 믿음을) 더 확실히 갖게 하다
cramp : (무엇의 발달이나 진행을) 방해하다
never mind : 신경쓰지 마
water-cooler : <사무실 직원들이, 예컨대 음료수 마시는 곳 근처와 같이, 격의 없이 이야기를 나누는 곳을 가리킴>
clique : 파벌
casually : 우연히
insurance : 보험
convolute : 뒤얽히다
mess with something : (해로울지도 모르는) ~에 얽혀 들다
purposefully : 목적의식이 있는
baron : (특정 산업 분야의) 거물
ransom : (납치유괴된 사람에 대한) 몸값
stick to : (어려움을 참고) ~을 계속하다
call the shots : 지배하다
at the end of the day : 결국에는
beneath : 아래에
take side : 편들다
vulnerable
patronage : (지지자들에게 그 대가로 하는) 지원
on merit : 공과에 따라
to one's dismay : 놀랍게도
geared : (…에 맞도록) 설계된
favour : (계획, 제안 등에) 호의를 보이다
awkward : 불편한
Let Your Hair Down : 느긋하게 즐기다
assassinate : 암살하다
herald : (앞으로 있을 일을) 예고하다
cooperative : 협동조합
enlighten : (설명하여) 이해시키다
tyranny : 폭압
liberation : 해방
render : (특히 어떤 것에 대한 대가로 또는 기대에 따라) 주다
beset by : ~으로 괴로움을 당하는
mob : 무리
justice : 재판
guillotine : 단두대
crown : 왕위에 앉히다
exacerbate : (특히 질병, 문제를) 악화시키다
asymmetrical : 불균형적인
fondly : 애정을 듬뿍 담고
exert : (권력, 영향력을) 가하다
damning : 유죄를 강력 시사하는
headlong : 성급하게
cohesion : 화합
authority : 지휘권, 당국
rigid : 융통성 없는
onward : 앞으로 나아가는
prosperity : 번영
pave : (벽돌 등으로) 포장하다
denote : 의미하다
interplay of(between) A and B : A와 B의 상호작용
sort of : 어느 정도
down the road : 앞으로
stylus : 스타일러스(특수 컴퓨터 화면에 글을 쓰거나 그림을 그리는 등의 표시를 할 때 쓰는 펜)
carry around : 휴대하다
put something away : (다 쓰고 난 물건을 보관 장소에) 넣다
yuck : 윽(역겨울 때 내는 소리)
phenomenal : 경이적인
accurate : 정확한
patent : 특허를 받다
interrogative : 질문하는
ahead of : (공간, 시간상으로) 앞에
sophisticated : (기계, 시스템 등이) 정교한
cripple : 제대로 기능을 못 하게 만들다
famous for
brought
hit the ground running : (성공적으로) 잘 나가다
accredit : 승인하다
institution : 기관
eligible : (자격, 연령 등의 조건이 맞아서) ~을 할 수 있는
affiliation : 제휴
consent : 동의하다
pioneer : (특정 지식문화 부문의) 개척자
quote
recently
run across : ~을 우연히 만나다
millionth : 100만 번째
informal : 격식에 얽매이지 않는
wander : (이리저리 천천히) 거닐다
twirl : (춤을 추거나 하면서) 빙글빙글 돌다
convince : 설득하다
whimper : 훌쩍이며 말하다
chicken out : 겁을 먹고 (~을) 그만두다
even as : ~하는 바로 그 순간에
acknowledge : (사실을) 인정하다
altogether : 완전히
drive out of : ~에서 몰아내다
tackle a problem : 문제를 다루다
outreach : 지원 활동
encourage
refine : (작은 변화를 주어) 개선하다
likely : ~할 것 같은
eager : 열렬한
procurement : (특히 정부, 기관의 물품) 조달
devise : 고안하다
cover letter : 자기 소개서
candidacy : 출마
ilk : 종류
prevalent : (특정 시기, 장소에) 일반적인
concisely : 간결하게
preferably : 가급적이면
memorization : 암기
engage : (주의, 관심을) 사로잡다
astounding : 믿기 어려운
this time around(TTA) : 이번에
In particular : 특히
exhaustive : (하나도 빠뜨리는 것 없이) 철저한
in terms of(ITO) : ~에 관하여
annoyance : 짜증
not to mention(NTM) : ~은 말할 것도 없고
affirmative : 긍정의
one after another : 연달아
skittish : 겁이 많은
maneuver : 교묘히 이동시키다
admiration : 존경
lucid : (특히 질병, 의식 혼미 상태 중이거나 후에) 의식이 또렷한
wonder if : ~여부를 궁금해하다
sing along : (~에 맞춰) 노래하다
exorcism : 나쁜 기억을 잊기 위한 행동
snort : 코웃음을 치다
choke on : ~이 목에 걸리다
scrap : 한 조각
lap : (자리에 앉았을 때 양 다리 위의 넙적한 부분에 해당하는) 무릎
airily : 대수롭지 않다는 듯
pinched : 파리한
scoff : 비웃다
in matters of : ~에 관해서는
betrayal : 배신
lean : 기울이다
scoop up : 퍼 올리다
remembrance : 추억
even : 차분한
out of nowhere : 뜬금없이
yell : 외치다
urge : ~하도록 충고하다
neighborhood : 주위
figure it out : 알아내다
waffling : 모호한
on a whim : 즉흥적으로
heroine : 여자 주인공
hero : 남자 주인공
protagonist : 주인공
best of five : 5판 3승 승부의
highest
gorgeous : 아주 멋진
fluent : (언어, 특히 외국어 실력이) 유창한
dismiss : (생각, 느낌을) 떨쳐 버리다
proximity : (거리, 시간상으로) 가까움
motorway : 고속도로
highway : 고속도로
spurious : 비논리적인
take it away : 시작!
ambient : 주변의
accelerometer : 가속도계
in a minute : 당장
portrait : 세로 방향의
landscape : 가로로 긴 배치
palm : 손바닥
tailor : (특정한 목적, 사람 등에) 맞추다
staircase : 계단
start off : (~ 하는 것으로) 시작하다
recurrence : 반복
build up : (~이 되도록) 점점 커지다
lawsuit : 고소
deposition : 증언 녹취록
discrimination : 차별
age discrimination : (고용) 연령 차별
several
accuse : 고발하다
class-action case : 집단 소송
file : (소송 등을) 제기하다
statement : 진술서
Big Blue : IBM의 별명
struggle with : (나쁜 상황, 결과를 막기 위해) 싸우다
Canada
revenue
jurisdiction : 관할 구역
retool : (조직을) 개편하다
workforce : (특정 기업, 조직 등의) (모든) 직원
revolution : 혁명
lowest
determine
Inc. : Incorporated : 주식회사
fuddy-duddy : 시대에 뒤진 사람
set out : (일, 과제 등에) 착수하다
slough off : (더 이상 필요 없는) ~을 없애다
over the course of time : (time) ~동안
plaintiff : 고소인
motion : 발의
file a motion to dismiss : 기각 신청을 하다
under oath : 선서를 하고
seniority : (근무 햇수에 따른) 연공서열
receptive : (새로운 사상, 제안에 대해) 수용적인
align with : ~에 맞춰 조정하다
extensive : (다루는 정보가) 폭넓은
estimate : 추정
comprehension : 이해력
grocery store
truthfully : 정직하게
along the way : 그 과정에서
impeccable : 흠 잡을데 없는
morph : 변하다
on and on : 계속해서
dropout : 중퇴자
resist
adolescent : 청소년
grateful : 고마워하는
as far as : ~에 관한 한
resentful : 억울해 하는
unmet : (욕구 등이) 충족되지 않는
harbour : harbor : (특히 좋지 않은 감정을 오랫동안 마음속에) 품다
improbable : 희한한
beckon : (가능성이) 조짐을 보이다
contemplate : 심사숙고하다
practically : 사실상, 거의
drily : (농담을) 은근슬쩍
lay down : 내려 놓다
snicker : giggle : snigger : 낄낄 웃다
hook up with somebody : ~와 만나서 시간을 보내다
otherwise : 그렇지 않았다면
beware of : ~에 주의하라
streak : (특히 스포츠에서 성공, 실패의) 연속
trait : (성격상의) 특성
adjustment
tear : 찢다
pull off : (옷이나 스타일 등을) 잘 소화하다
feasibility : (실행) 가능성
substantially : 상당히
entitle to : ~에게 권리를 주다
vary : (상황에 따라) 다르다
subsequently : 그 뒤에
transparency : 명료성
meant to be : 인연
thick : 두꺼운
envy : 부러워하다
stir : 젓다
unspool : (실감개 따위에 감긴 것이) 풀어지다
significance : 의미
lug : (무거운 것을 힘들게) 나르다
chin : 턱
on the way over to : ~에 가는데
bipolar : 조울증의
though : ~이긴 하지만
sneak : 몰래 가다
stationery : 편지지
sleepover : (아이들이나 청소년들이 한 집에 모여) 밤샘 파티
suspend : 정직(정학)시키다
in a braid : 머리를 한 갈래로 땋은
shush : 쉿
point out : 언급하다
run through something : ~을 빨리 살펴보다
catch breath : 숨을 돌리다
sherbet
dangle : (무엇이) 달랑거리다
excuse : 변명 (명사 익, 동사 엑)
momentous : 중대한
in a while : 한동안
uncover : (비밀 등을) 알아내다
set aside : 확보하다
sit down to : ~에 열심히 착수하다
blow away : ~를 뿅가게 만들다
outside-of-work : 업무 외적인
condensed : 요약한
paramount : 가장 중요한
undoubtably
pay close attention to : ~에 세심한 주의를 하다
logistics : 실행 계획
upon you(us, ...) : 목전에 닥친
unprecedented : 전례 없는
autonomous : 자율적인
vehicle
explode : 폭발적으로 증가하다
sphere : (활동, 영향, 관심) 영역
hype : 아주 멋진
emphasis on : ~을 강조
parallelization
label
model
stochastic : 확률론적인
gradient : (두 지역간의) 변화도
descent : 하강
suitable
tentative : 잠정적인
prerequisite
familiarity : 익숙함
plagiarism : 표절
ethics : 윤리
fast-paced
commitment : (돈, 시간, 인력의) 투입
grant : (정부나 단체에서 주는) 보조금 : (특히 공식적, 법적으로) 승인하다
acknowledgements : (특히 책 서두에 붙이는) 감사의 글
adapted from : ~에서 개조된
dredge : (강, 운하 바닥 등을) 준설하다
derogatory : 비판적인
refer to something : ~을 나타내다
underlying : 근본적인
appropriately : 알맞게
moviegoer : 영화 구경을 자주 가는 사람
standard deviation : 표준 편차
other than : ~외에 : ~이 아닌
succinct : 간결한
prominent : 중요한
characterization
diaper : (아기의) 기저귀
bogus : 가짜의
squirrel : 다람쥐
sales : 매출
evil-doer : 악당
periodically : 주기적으로
examine : 조사하다
suspicious : 의심스러운
two orders of magnitude : 두 자릿수[100배]
phenomena : phenomenon의 복수
logarithm : 로그
recapitulation : 개요
commodity : 물품
redundancy : 중복
tolerant : 내성이 있는
acyclic : 비순환적인
redundantly : 과다하게
prevalence : 널리 퍼짐
installation : 장치
bandwidth : 대역폭
abort : (일을) 중단시키다
somewhat : 약간
exploit : (최대한 잘) 활용하다 (명사 엑, 동사 익)
enormous : 거대한
coordination : 조직화
wind up : (어떤 장소, 상황에) 처하게 되다
schematic : 도식으로 나타낸
arbitrary : 제멋대로인
commutative : 가환성의 (제시된 수의 순서에 상관없이 결과가 동일한)
destine for : <어떤 목적, 용도로> 예정해 두다
fork : 나뉘다
reside : (특정한 곳에) 거주하다
milieuI : (사회적) 환경
discoverable : 쉽게 검색할 수 있는
analogous : 유사한
resilient : 회복력 있는
exemption : 면제
reputation : 명성
earthworm : 지렁이
meanwhile : 그 동안에
secretary : 비서
punctuation : 구두점
revise : (책, 견적서 등의 내용을 바로잡기 위해) 수정하다
firm : 탄탄한
notion : 개념
compartmentalize : (특히 서로 영향을 주지 않도록) 구분하다
on behalf of somebody : ~ 을 대신하여
instance : 사례
supersede : 대체하다
passive : 수동적인
circumstance
reception : 수신 상태
delineate : (상세하게) 설명하다
excess : 초과한
impose : (힘들거나 불쾌한 것을) 부과하다
datum : (하나의) 자료[정보, 데이터]
privilege : 특혜
reclaim : (분실하거나 빼앗긴 물건 등을) 되찾다
orphan : 고아
and so forth : 등등
sluggish : 느릿느릿 움직이는
recipient : 수령인
necessitate : ~을 필요하게 만들다
provision : (법률 관련 문서의) 조항
rendezvous : 만날 약속
trivial : 사소한
merely : 그저
configure : (컴퓨터의) 환경을 설정하다
truncate : (아래나 위를 잘라서) 길이를 줄이다
conduit : (액체나 기체를 통하게 하는) 도관
deduct : (돈, 점수 등을) 공제하다[감하다]
succinctly : 간결하게
accompany : (일, 현상 등이) 동반되다
criterion : (판단이나 결정을 위한) 기준
pledge : (정식으로) 약속[맹세]하다
oath : 맹세
nature : 종류
mutual : (둘 이상 사람들) 공통의
descending
ascending
tame : 길들이다
fall into something : ~으로 나뉘다
intermediary : 중재자
prone : (좋지 않은 일을) 하기[당하기] 쉬운
facilitator : (지시하는 사람이 아닌) 조력자
sue : 고소하다
erroneous : 잘못된 (정보에 의한)
malicious : 악의적인
terminology
collective : 집단의
stand for something : (약어나 상징물이) ~을 나타내다[의미하다]
undergo : (특히 변화·안 좋은 일 등을) 겪다[받다]
courtesy : 공손함
canonical : (수학에서) 표준[기준]이 되는
look for something : ~을 바라다
come across : ~을 우연히 발견하다
capable of : ~을 할 수 있는
thorough : 철저한
CC : carbon copy(참조)
disincentive : 의욕을 꺽는 것
tricky : (하기·다루기) 힘든[까다로운], 곤란한
consistent : 일관성 있는
polish : (좋아지도록) 다듬다
nitpick : 자잘한 일에까지 간섭하다
justify : 정당화시키다[하다]
keep in mind : 명심해
purely
resolve : (문제 등을) 해결하다
overrule: 기각하다
dictate : ~에 영향을 주다
VC : Video Call
escalate : 확대시키다
sit around : 빈둥거리며 세월을 보내다
take into account : ~을 고려하다
introduce : (새로운 것을) 시작하다
vigilant : 바짝 경계하는
sensible : 합리적인
scrutiny : 철저한 검토
judgment call : 개인적 의견
scan over : 훑어보다
internationalization : 국제화
address : (문제·상황 등에 대해) 고심하다[다루다]
conform : (규칙·법 등에) 따르다[맞다]
compliment somebody on something : ~에게 ~에 대해 칭찬하다
courteously : 공손하게
drastically : 과감하게
partition : 나누다
identity : 독자성
elapse : (시간이) 흐르다[지나다]
respect : (법률원칙 등을) 준수하다
deal with : (문제, 과제 등을) 처리하다
predicate : (특정 신조, 생각, 원칙에 …의) 근거를 두다
lineage : 혈통
consecutive : 연이은
sufficiently : 충분히
convergence : 수렴
bundle : (소프트웨어 등을) 추가로 주다
particular : (명사 앞에만 씀) 특정한
bank balance : 은행 잔고
primitives : 기초 요소
dominant : 우세한
reasoning : 추론
product : 곱
capital : 대문자
proportion : 비율
sparse : (흔히 넓은 지역에 분포된 정도가) 드문
matrices : matrix의 복수
synopsis : (글·희곡 등의) 개요
substitute : 대신하다
neglect : 도외시하다
prime divisor : 소인수
protest : (특히 공개적으로) 항의하다
complaint : 불평
trump : 으뜸패를 내다
ease : (고통, 불편 등이) 덜해지다
specify : (구체적으로) 명시하다
improve : 개선하다
compromise : (원칙 등을) 굽히다
intuitively : 직관적으로
disease : 질병
formalize : 공식화하다
variant : 변종
thrash : 허우적거리다
lexicographic order : 사전식 순서
monotonicity : 단조성
throughout : ~동안
for the moment : 잠깐 동안은
expense : 비용
amplify : 증폭시키다
sparsity : 희박
evidently : 확실히
prune : (불필요한 부분을) 가지치기하다
majority : (특정 집단 내에서) 다수
subtlety : 미묘함
consequently : 따라서
successive : 연속적인
if and only if : 필요충분조건
retain : 유지하다
rationale : (특정한 결정, 행동 방침, 신조 등의) 이유
lend : (도움, 지지 등을) 주다
regime : 제도
strain : 부담
contradiction : 모순
at hand : 즉시 쓸 수 있도록
adequate : 충분한
decay : 쇠퇴하다
constrain : ~하게 만들다
uncharted : 미지의
ingredient : (요리 등의) 재료
criteria : criterion의 복수형
at most : 많아 봐야
quintuple : 다섯 부분으로 된
transaction : 처리 (과정)
defer : 미루다
preempt : <공유지를> 선매권을 얻기 위해 점유하다
cast for : (~에게) 표를 던지다
primarily : 주로
skim : (필요한 부분을 찾거나 요점을 알기 위해) 훑어보다
virtually : 사실상
comprise : ~으로 구성되다
leverage : 영향력
intensive : 집중적인
incur : (비용을) 발생시키다
interleave : 끼우다
the advent of ~ : ~의 출현
manipulate : (사물을 능숙하게) 처리하다
accommodate : (환경 등에) 맞추다
inherently : 본질적으로
exclusive : 독점적인
drawback : 문제점
burden : 부담을 지우다
equivalent : 동등한
remainder : 나머지
specification : 설명서, 사양
enclose : 둘러싸다
loom : 어렴풋이 보이다
on the horizon : 곧 일어날 듯한
undertake : (책임을 맡아서) 착수하다
superior : (~보다 더) 우수한
troublesome : (오랫동안) 골칫거리인
exhaust : 고갈시키다
directive : (공식적인) 명령
and so forth : ~ 등등
semantics : 의미
yield : 양도하다
inadequate : 부적당한
convoy : (특히 군인이나 다른 차량의) 수송대
implication : (행동·결정이 초래할 수 있는) 영향[결과]
affinity : 관련성
consequence : (발생한 일의) 결과
crude : 대충의
incidentally : 그런데
auxiliary : 보조[예비]의
contiguous : 인접한
preliminary : 예비의
contrariwise : 반대로
symptom : 증상
lower : 낮추다
scuba : 스쿠버
embody : (사상·특질을) 상징[구현]하다 : 포함하다
notation : 표기법
juxtapose : 나란히 놓다
whereby : (그것에 의하여) ~하는
unary : 단항 (수학)
precedence : 우선[함]
derivation : (단어의) 어원
conformance : 일치, 부합
analogy : 유추
propagate : (사상·신조·정보를) 전파하다
intervene : (상황 개선을 돕기 위해) 개입하다 : (방해가 되는 일이) 생기다[일어나다]
while : [문장 맨 첫 부분에 쓰여] ~이긴 하지만, ~에도 불구하고
precise : 정확한
fringe : 주변부[변두리]
tempt : (좋지 않은 일을 하도록) 유혹하다
aid : (특히 일이 수월해지도록) 돕다
